













